
11111111111111111111111111
111100000000000000000000001
1110000000N01001111111111111
1111111110000000000000111111
100000000000000000000001
111111111111111111111111111111
