NO ./mandatory/images/north.xpm
SO ./mandatory/images/north.xpm
WE ./mandatory/images/north.xpm
EA ./mandatory/images/north.xpm



F 0,76,211
C 16,255,3

11111111111111111111111111111111111111111111111111111111111111111
10010000000010000000000010000000000001000000000000000000000000011
10011111000010000000000010000000000001000000000100000001111110011
10000001000010000000000011111011111001000000000100000001000000011
10000001000011111101111110000000001001000000000100000001000000011
10000001000000000000000000000000001001000000000111111111111111111
10000000000000000000000000000000001101000000000001111
10000001000000000N00000000000000000000000000000100011
10000001000000000000000000000000000000000011111111111
111111110000010000000000000000000000000000100000000011111111111
100000000000010001111111100000000000000000100000000000000000001
100000000000010001100001100001111000000000000001111111111111111
100000000000011111100001100001100000000000100011
111100000000000000000001111111100000000000111111
111111111111111111111111111111111111111111111111
